常用工具：
draw.io ---> 画框架图
freeplane ---> 画思维导图
graphviz ---> 画类图
Typora ---> 笔记
Astah Professional ---> 画流程图

autohotkey ---> 设置windows快捷键
tinytask ---> 重复性脚本工作
cmd工具 ---> windows terminal       水平分屏 alt + shift + - (减号) 垂直分屏 alt + shift + + (加号)

notepad++ ---> 文本分析
TextAnalysisTool.NET ---> 文本分析
uedit64 ---> 文本编辑分析
Beyond Compare 4 ---> 代码比较

source insight ---> 看代码工具
codeblocks ---> ide
Visual Studio Code ---> ide
Android Studio ---> ide

MobaXterm ---> 终端工具
tmux ---> 会话管理工具
      tmux new -s “name”   //启动一个名为name的会话
      tmux a -t “name”     //接入某个已经存在的会话
      tmux ls              //查看当前已有会话

FScapture ---> 截图工作
zoomit ---> 涂鸦工具
simple sticky notes ---> 便签工具

audition ---> 音频编辑和分析
Audacity ---> 音频编辑和分析
VLC media player ---> 媒体播放

Aiseesoft PDF Splitter ---> 免费pdf分割器，使用时要注意，如没有pdf权限会不成功。
PDFsam Basic ---> 免费pdf分割器
